##############??##############
##############  ##############
########      BB    ##########
######## ########## ##########
######## ########## ##########
######## ###### C         ####
######## ####   ######### ####
######## #### P ######### ####
######## #### 2 ######### ####
######## ####   ########  BP##
######## ####C##########   B##
######## #### ##########    ##
######## #### #            ###
######## ####    #############
########       1      C  o   ?
#############    ########### ?
#############  A #############
############### ##############
############### ##############
############### ##############
############### ##############
###############       ########
##################### ########
#####################     ####
#######################ABA####
####################### P ####
#######################331####
##############################
##############################
##############################
Est : niveau3.level
Sud :
Ouest :
Nord : niveau2.level

A
Pv : 5
Force : 1
Armure : 1

B
Pv : 10
Force : 2
Armure : 3

C
Pv : 20
Force : 5
Armure : 5
